............#.....$
...............#...
...............#...
.........#.........
....#..............
.........#.........
.#.................
........#..........
#..................
.........@....#....
.......#...........
.....#.............
.........#.........
#..................
.......#...........
............#......
...#...............
..................#
.......#...........