.....#..$
.#.......
.#.......
#........
...#@....
......#..
....#....
........#
.#.......