...#..........$
.....#.........
............#..
....#..........
..#............
#..............
....#..........
......#@.......
.....#.........
....#..........
.........#.....
............#..
..#............
......#........
#..............